#.........................##..................................................................................................................................
#.........................##..................................................................................................................................
#.@.......................##..................................................................................................................................
###################.......##.........##.......................................................................................................................
#.........................##..................................................................................................................................
#.........................##..................................................................................................................................
#.................#################...........................................................................................................................
#...............#####.........................................................................................................................................
#####.......#######...........................................................................................................................................
#.............................................................................................................................................................
#......###....................................................................................................................................................
#.....##......................................................................................................................................................
#.............................................................................................................................................................
##............................................................................................................................................................
#####.................########################################################################################################################################
#######.....##################################################################################################################################################
##############################################################################################################################################################