###################################################################
###################################################################
#####.........................................................#####
#####.....................................................s...#####
#####....s....................................................#####
#####..............................................###############
#############.................................................#####
#####.........................................................#####
#####.....................................................s...#####
#####..@......................................................#####
#####.........................................................#####
###################################################################
###################################################################