..................................................................
..................................................................
..................................................................
.................................................###....####....
.................................................####..#######.
..................................................##############
.................................................#################
..................................................##################
#################################..................#########################......................
######################################............###############################################.......................#####
############################################.......#####################################################...............######
######################################################################.........###............####........#####.........#####
####################################################################...........................#.........................####
####################################################################.............................................###......###
####################################################################......................................................###
####################################################################...@............##....######################..........###
#############################################################################################################################