..................................................................
..................................................................
..................................................................
.................................................###....####....
.................................................####..#######.
..................................................##############
#............s......s..........................#################    
##...............................................##################
#################################.................#########################......................
######################################............###############################################.......................#####
############################################.......#####################################################...............######
######################################################################.........###............####........#####.........#####
####################################################################...........................#.........................####
####################################################################..............................s.............###..#...###
####################################################################.................................................s..#####
####################################################################...@............##....######################.......######
#############################################################################################################################